NO textures/north_texture

SO textures/south_texture

EA textures/west_texture

WE textures/east_texture

F 121,    124,    125
C 56,    165,    199

1111111111111111111111111
1000000000110000000000001
1011000001110000000000001
10010000000000000000000011111111
111111111011000001110000000000001
100000000011000001110111111111111
11110111111111011100000010001
11110111111111011101010010001
11000000110101011100000010001
10000000000000001100000010001
10000000000W00001101010010001
1100000111010101111101111000111
1111011111110101 101111010001
11111111 1111111 111111111111