NO textures/north_texture

SO textures/south_texture

EA textures/west_texture

WE textures/east_texture

F 255,255,255
C 225,30,0

1111111111111111111111111
1000000000110000000000001
1011000001110000000000001
10010000000000000000000011111111
111111111011000001110000000000001
100000000011000001110111111111111
11110111111111011100000010001
11110111111111011101010010001
11000000110101011100000010001
1000000000000000110000N010001
10000000000000001101010010001
1100000111010101111101111000111
1111011111110101 111111010001
11111111 1111111 111111111111
1111111111111111111111111
