NO textures/eagle.xpm

SO textures/greystone.xpm

EA textures/purplestone.xpm

WE textures/red.xpm

F 65,152,10
C 191,221,221

111111111111111111111111111111111111111111111111111111111111111111111111111111111111
100000000000000000000000000000000000000000000000000000000000000000000000000000000001
100000000000000000000000000000000000000000000000000000000000000000000000000000000001
100000000000000000000000000000000000000000000000000000000001111111111111100000000001
100000000000000000000000000000000000000000000000000000000001000000000000100000000001
100000000000000000000000000000000000000000000000000000000001000000000000100000000001
100000000000000000000000000000000000000000000000000000000001000000000000100000000001
100000000000000000000000000000000000000000000000000000000001111111000000100000000001
100000000000000000000000000000000000000000000000000000000001000000000000100000000001
100000000000000000000000000000000000000000000000000000000001000000000000100000000001
100000000000000001000000000000000000000000000000000000000001000000000000100000000001
100000000000000001000000000000000000000000000000000000000001000000000000100000000001
100000000000000001000000000000000000000000000000000000000001000000000000100000000001
100000000000000001000000000000000000000000000000000000000001000001111111100000000001
100000000000000001000000000000000000000000000000000000000001000000000000000000000001
100000000000000001000000000000000000000000000000000000000000000000000000000000000001
100000000000000001000000000000000000000000000000000000000000000000000000000000000001
100000000000000001000000000000000000000000000000000000000000000000000000000000000001
100000000000000001000000000000000000000000000000000000000000000000000000000000000001
100000000000000001000000000000000000000000000000000000000000000000000000000000000001
100000000000000001000000000000000000000000000000000000000000000000000000000000000001
100000000000000000000000000000000000011111111111111100000000000000000000000000000001
100000000000000000000000000000000000000000000000000000000000000000000000000000000001
100000000000000000000000000000000000000000000000000000000000000000000000000000000001
100000000000000000000000000000000000000000000000000000000000000000000000000000000001
100000000000000000000000000000000000000000000000000000000000000000000000000000000001
100000000000000000000000000000000000000000000000000000000000000000000000000000000001
100000000000000000000000000000000000000000000000000000000000000000000000000000000001
100000000000000000000000000000000000000000000000000000000000000000000000000000000001
100000000000000000000000000000000000000000000000000000000000000000000000000000000001
100000000010000000000000000000000000000000000000000000000000000000000000000000000001
100000000010000000000000000000000000000000000000000000000000000000000000000000000001
100000000010000000000000000000000000000000000000000000000000000000000000000000000001
100000000010000000000000000000000000000000000000000000000000000000N00000000000000001
100000000011111111111110000000000000000000000000000000000000000000000000000000000001
100000000010000000000000000000000000000000000000000000000000000000000000000000000001
100000000010000000000000000000000000000000000000011111111111111111000000000000000001
100000000010000000000000000000000000000000000000011111111111111111000000000000000001
100000000000000000000000000000000000000000000000011111111111111111000000000000000001
100000000000000000000000000000000000000000000000011111111111111111000000000000000001
100000000000000000000000000000000000000000000000011111111111111111000000000000000001
100000000000000000000000000000000000000000000000011111111111111111000000000000000001
100000000000000000000000000000000000000000000000011111111111111111000000000000000001
100000000000000000000000000000000000000000000000011111111111111111000000000000000001
100000000000000000000000000000000000000000000000011111111111111111000000000000000001
100000000000000000000000000000000000000000000000000000000000000000000000000000000001
100000000000000000000000000000000000000000000000000000000000000000000000000000000001
100000000000000000000000000000000000000000000000000000000000000000000000000000000001
100000000000000000000000000000000000000000000000000000000000000000000000000000000001
100000000000000000000000000000000000000000000000000000000000000000000000000000000001
100000000000000000000000000000000000000000000000000000000000000000000000000000000001
100000000000000000000000000000000000000000000000000000000000000000000000000000000001
100000000000000000001111111111111110000000000000000000000000000000000000000000000001
100000000000000000000000000000000000000000000000000000000000000000000000000000000001
100000000000000000000000000000000000000000000000000000000000000000000000000000000001
100000000000000000000000000000000000000000000000000000000000000000000000000000000001
100000000000000000000000000000000000000000000000000000000000000000000000000000000001
100000000000000000000000000000000000000000000000000000000000000000000000000000000001
100000000000000000000000000000000000000000000000000000000000000000000000000000000001
100000000000000000000000000000000000000000000000000000000000000000000000000000000001
100000000000000000000000000000000000000000000000000000000000000000000000000000000001
111111111111111111111111111111111111111111111111111111111111111111111111111111111111
